R 1920 1080
NO  /Users/kgale/CLionProjects/cub/texture_examples/1.xpm
SO /Users/kgale/CLionProjects/cub/texture_examples/2.xpm
WE /Users/kgale/CLionProjects/cub/texture_examples/3.xpm
EA /Users/kgale/CLionProjects/cub/texture_examples/4.xpm
S /Users/kgale/CLionProjects/cub/texture_examples/sprite1.xpm
F 220,100,0
C 225,30,0

1111111111111111111111111
1000000000110000000000001
1011000001110000002000001
100100000000000000000000111111111
111110111011000001110000000000001
100000000011000001110111111111111
11110111111111011100000010001
11110111111111011101010010001
11000000110101011100000010001
1000200000000000110E020010001
10000000000000001101010000001
110000011101010111110111100111
11110111 1110101 101111010001
11111111 1111111 111111111111
