R 1924 1080

NO /Users/kgale/Desktop/cub/texture_examples/1.xpm
SO /Users/kgale/Desktop/cub/texture_examples/2.xpm


EA /Users/kgale/Desktop/cub/texture_examples/4.xpm

S             /Users/kgale/Desktop/cub/texture_examples/cat.xpm




F 255,255,255
WE /Users/kgale/Desktop/cub/texture_examples/4.xpm
C 101,67,33

     1111111111111
   11100000000000111
  1100000000000000011
 110000000000000000011
11000000000N00000000011
100000000000000200000011
100000000000000000000001
100000020000000000000001
100000000000000000020001
1000000000000000000000011                                       11111111111
1000020000002000000000001                                      1100000000011
10000000000000000000000011111111111111111111111111111111111111110000000000011
100000000000000000020000000000000000000000000000000000000000000000000000000011
1100000000000000000000000000000000000000020000000000000000000000000000000000011
 100000000200000000000000000000020000000000000000000000000000000000000000000011
 100000000000000000000002000000000000000000002000000000000020000000000000000001
 110000000000000000000000000000000000000000000000000000000000000000000000000001
  10000000000000000000000000000000000000000000000000000000000000000000000000001
  11000000000200000000000000000000000000000000000000000000000000000000000000011
   110000000000000000000000000000000000000000000200000000000000000000001111111
  11000000000000000000200000000000000000000000000000020000000000002000000000011
  10000000000000000000000000000000020020000000000000000000000000000000000000001
 110000000002000000000000000000000000000000000000000000000000000000000000000001
 100000000000000000000000000000000000000000000000000000000000000000000000000001
 100000020000000000000000200000000000000000002000000000000000002000000000000011
1100000000000000000000000000000000000000000000000000000000000000000000000000011
100000000000020000000000000000000000000000000000000002000000000000002000000011
10000000000000000000000001111111111111111111111111111111111111100000000000011
10000000000000000000000011                                    11000000000011
1000020000000000000000011                                      111111111111
100000000000000000000001
100000000000000002000001
100000000000000000000001
110000002000000000000011
 1100000000000002000011
  11000000000000000011
   111000000000000111
    111111111111111
