R 1924 1080

NO /Users/kgale/Desktop/cub/texture_examples/1.xpm
SO /Users/kgale/Desktop/cub/texture_examples/2.xpm


EA /Users/kgale/Desktop/cub/texture_examples/4.xpm

S             /Users/kgale/Desktop/cub/texture_examples/cat.xpm




F 255,255,255
WE /Users/kgale/Desktop/cub/texture_examples/4.xpm
C 101,67,33

     111111111111
   1110000000000011
  110000000000000001
 11000000000000000001
11000000000N0000000001
10000000000000020000001
100000000000000000000001
100000020000000000000001
100000000000000000020001
100000000000000000000001                                        1111111111
1000020000002000000000001                                      100000000001
1000000000000000000000001111111111111111111111111111111111111110000000000001
10000000000000000002000000000000000000000000000000000000000000000000000000001
 10000000000000000000000000000000000000002000000000000000000000000000000000001
 10000000020000000000000000000002000000000000000000000000000000000000000000001
 100000000000000000000002000000000000000000002000000000000020000000000000000001
  10000000000000000000000000000000000000000000000000000000000000000000000000001
  10000000000000000000000000000000000000000000000000000000000000000000000000001
   100000000020000000000000000000000000000000000000000000000000000000000000001
    1000000000000000000000000000000000000000000020000000000000000000000111111
   100000000000000000020000000000000000000000000000002000000000000200000000001
  10000000000000000000000000000000020020000000000000000000000000000000000000001
  10000000002000000000000000000000000000000000000000000000000000000000000000001
 100000000000000000000000000000000000000000000000000000000000000000000000000001
 10000002000000000000000020000000000000000000200000000000000000200000000000001
 10000000000000000000000000000000000000000000000000000000000000000000000000001
10000000000002000000000000000000000000000000000000000200000000000000200000001
1000000000000000000000000111111111111111111111111111111111111110000000000001
1000000000000000000000001                                      100000000001
100002000000000000000001                                        1111111111
100000000000000000000001
100000000000000002000001
100000000000000000000001
 1000000200000000000001
  10000000000000200001
   100000000000000001
    1100000000000011
      111111111111
