R 1000 1000
NO /Users/kgale/CLionProjects/cub/texture_examples/gene.xpm
SO /Users/kgale/CLionProjects/cub/texture_examples/peter.xpm
WE /Users/kgale/CLionProjects/cub/texture_examples/ace.xpm
EA /Users/kgale/CLionProjects/cub/texture_examples/paul.xpm
S /Users/kgale/CLionProjects/cub/texture_examples/sprite1.xpm
F 209,209,209
C 23,236,255


111111111     111111111                    1111111  1111111
1W0000001     1000000011                   10000011 1000001
1100000011    1100000001                   11000001 1000001
 1100000011    100000011                    1100001 11000111
  111002001    11000001     11111111111111   1100011 1100001   1111111111111
    1000001    11000001   111000000000000111  100001  100001 11100000000000111
    1000001111110000001  110000001111100000111100001  100001 10000000000000001
    1000000000000000001  100000011   110000000000001  100001 10000111111100001
    1002000002000000001  100000001111100000111100001  100001 100001     100001
    1000000111110000001  1000000000000000001  100001  100001 100001     100001
    10000011   11000001  1000000111111111111  100001  100001 100001     100001
   11000001     1000001111100000001           100001  100001 100001     100001
  110000001     1000000000000000001          110000111100001110000111111100001
  100000001     100000001111000000111111111  100000000000000000000000000000011
  100000001     100000001  1100000000000001  10000001100000011111000000000011
  111011111     111111111   111111111111111  1111111111111111   111111111111
    101
   11011111     11111111    111111111111111111
  110000001     10000001    100000000000000001
  100000001    110000001    100000000000000001
  111100001    111100001    100000111111111111
     100001       100001    1000001
     100001       100001    1000001
     100001       100001    10000011111111111
     100001       100001    100000000000000011
     100001       100001    1111111111110000011
     100001       100001               11000001
     100001       100001                1000001
     100001       100001   111111111   11000001
  111100001111111110000111110000000111110000001
  100000000000100000000000001110000000000000111
  100000000000000000000000111 111000000000111
  1111111111111111111111111     11111111111
